1111111111
1        1
1        1
1        1
1223     1
1     33 1
1        1
1   32   1
1     2221
1111111111